If	IN	if
Johnny	NP	Johnny
Depp’s	NP	<unknown>
mesmerizing	VBG	mesmerize
performance	NN	performance
—	NN	<unknown>
a	DT	a
bracing	VBG	brace
return	NN	return
to	TO	to
form	VB	form
for	IN	for
the	DT	the
star	NN	star
after	IN	after
a	DT	a
series	NN	series
of	IN	of
critical	JJ	critical
and	CC	and
commercial	NN	commercial
misfires	VBZ	misfire
—	NN	<unknown>
is	VBZ	be
the	DT	the
chief	JJ	chief
selling	NN	selling
point	NN	point
of	IN	of
Black	NP	Black
Mass	NP	Mass
,	,	,
there	EX	there
is	VBZ	be
much	RB	much
else	RB	else
to	TO	to
recommend	VB	recommend
this	DT	this
sober	JJ	sober
,	,	,
sprawling	JJ	sprawling
,	,	,
deeply	RB	deeply
engrossing	VBG	engross
evocation	NN	evocation
of	IN	of
Bulger’s	NP	<unknown>
South	NP	South
Boston	NP	Boston
fiefdom	NN	fiefdom
and	CC	and
his	PP$	his
complex	JJ	complex
relationship	NN	relationship
with	IN	with
the	DT	the
FBI	NP	FBI
agent	NN	agent
John	NP	John
Connolly	NP	Connolly
,	,	,
played	VBN	play
with	IN	with
equally	RB	equally
impressive	JJ	impressive
skill	NN	skill
by	IN	by
Joel	NP	Joel
Edgerton	NP	Edgerton
.	SENT	.
