As	IN	as
notorious	JJ	notorious
gangster	NN	gangster
James	NP	James
“	NP	<unknown>
Whitey	NP	Whitey
”	NP	<unknown>
Bulger	NP	Bulger
,	,	,
Depp	NP	Depp
astounds	VBZ	astound
with	IN	with
one	CD	one
of	IN	of
the	DT	the
best	JJS	good
performances	NNS	performance
in	IN	in
his	PP$	his
long	JJ	long
career	NN	career
while	IN	while
co-star	NN	co-star
Joel	NP	Joel
Edgerton	NP	Edgerton
steps	VBZ	step
up	RP	up
equally	RB	equally
well	RB	well
as	IN	as
John	NP	John
Connolly	NP	Connolly
,	,	,
an	DT	an
ethically	RB	ethically
questionable	JJ	questionable
FBI	NP	FBI
agent	NN	agent
who	WP	who
flirts	VBZ	flirt
with	IN	with
the	DT	the
wrong	JJ	wrong
side	NN	side
of	IN	of
the	DT	the
law	NN	law
.	SENT	.
