While	IN	while
the	DT	the
helmer’s	JJ	<unknown>
myth-making	NN	myth-making
approach	NN	approach
makes	VBZ	make
for	IN	for
great	JJ	great
Capra-esque	NP	<unknown>
entertainment	NN	entertainment
,	,	,
younger	JJR	young
auds	NNS	<unknown>
may	MD	may
find	VB	find
it	PP	it
terribly	RB	terribly
old-fashioned	JJ	old-fashioned
—	NN	<unknown>
and	CC	and
they’d	NNS	<unknown>
be	VB	be
right	JJ	right
to	TO	to
think	VB	think
so	RB	so
,	,	,
although	IN	although
Spielberg	NP	Spielberg
would	MD	would
be	VB	be
the	DT	the
first	JJ	first
to	TO	to
admit	VB	admit
it	PP	it
was	VBD	be
his	PP$	his
intention	NN	intention
to	TO	to
play	VB	play
things	NNS	thing
classical	JJ	classical
.	SENT	.
