While	IN	while
the	DT	the
minions	NNS	minion
are	VBP	be
certainly	RB	certainly
little	JJ	little
,	,	,
yellow	JJ	yellow
and	CC	and
different	JJ	different
,	,	,
Minions	NNS	minion
has	VBZ	have
probably	RB	probably
mined	VBN	mine
them	PP	them
for	IN	for
about	RB	about
as	IN	as
much	JJ	much
comedy	NN	comedy
as	IN	as
they	PP	they
can	MD	can
provide	VB	provide
as	IN	as
leading	VBG	lead
men	NNS	man
.	SENT	.
