In	IN	in
Spanish	JJ	Spanish
,	,	,
"	''	"
sicario	NP	<unknown>
"	``	"
means	VBZ	mean
"	``	"
hitman	NP	hitman
.	SENT	.
"	``	"
In	IN	in
film	NN	film
terms	NNS	term
,	,	,
Sicario	NP	<unknown>
is	VBZ	be
sensational	JJ	sensational
,	,	,
the	DT	the
most	RBS	most
gripping	JJ	gripping
and	CC	and
tension-packed	JJ	<unknown>
spin	NN	spin
through	IN	through
America	NP	America
's	POS	's
covert	JJ	covert
War	NN	war
on	IN	on
Drugs	NNS	drug
since	IN	since
Steven	NP	Steven
Soderbergh	NP	Soderbergh
's	POS	's
Traffic	NN	traffic
15	CD	@card@
years	NNS	year
ago	RB	ago
.	SENT	.
