While	IN	while
it’s	NNS	<unknown>
more	RBR	more
technically	RB	technically
elaborate	VB	elaborate
treatment	NN	treatment
than	IN	than
the	DT	the
characters	NNS	character
have	VBP	have
ever	RB	ever
received	VBN	receive
,	,	,
it’s	NNS	<unknown>
also	RB	also
gentler	JJR	gentle
and	CC	and
more	JJR	more
eye-pleasing	NN	<unknown>
than	IN	than
any	DT	any
of	IN	of
Blue	NP	Blue
Sky’s	NP	<unknown>
other	JJ	other
features	NNS	feature
.	SENT	.
It‘s	NP	<unknown>
also	RB	also
a	DT	a
neat	JJ	neat
extension	NN	extension
of	IN	of
Schulz’s	NP	<unknown>
style—though	NP	<unknown>
,	,	,
granted	VBD	grant
,	,	,
no	RB	no
one	CD	one
needs	NNS	need
to	TO	to
see	VB	see
Pig-Pen’s	NP	<unknown>
permanent	JJ	permanent
cloud	NN	cloud
of	IN	of
filth	NN	filth
rendered	VBN	render
more	RBR	more
vividly	RB	vividly
.	SENT	.
