It’s	NP	<unknown>
this	DT	this
adoption	NN	adoption
not	RB	not
only	RB	only
of	IN	of
Minnie’s	NP	<unknown>
point	NN	point
of	IN	of
view	NN	view
but	CC	but
the	DT	the
voice	NN	voice
and	CC	and
narrative	JJ	narrative
style	NN	style
of	IN	of
her	PP$	her
half	NN	half
girlish	JJ	girlish
,	,	,
half	DT	half
womanly	JJ	womanly
outlook	NN	outlook
on	IN	on
life	NN	life
that	WDT	that
makes	VBZ	make
The	DT	the
Diary	NN	diary
of	IN	of
a	DT	a
Teenage	NN	teenage
Girl	NN	girl
such	PDT	such
a	DT	a
vibrant	JJ	vibrant
,	,	,
hopeful	JJ	hopeful
film	NN	film
.	SENT	.
