It	PP	it
is	VBZ	be
unexpectedly	RB	unexpectedly
moving	VBG	move
and	CC	and
occasionally	RB	occasionally
delightful	JJ	delightful
to	TO	to
spend	VB	spend
time	NN	time
with	IN	with
these	DT	these
titans	NNS	titan
of	IN	of
cinema	NN	cinema
as	IN	as
they	PP	they
walk	VBP	walk
and	CC	and
sometimes	RB	sometimes
wobble	NN	wobble
,	,	,
delivering	VBG	deliver
words	NNS	word
that	WDT	that
become	VBP	become
meaningful	JJ	meaningful
because	IN	because
they	PP	they
're	VBP	be
lucky	JJ	lucky
enough	RB	enough
to	TO	to
be	VB	be
spoken	VBN	speak
by	IN	by
Mr.	NP	Mr.
Redford	NP	Redford
and	CC	and
Mr.	NP	Mr.
Nolte	NP	Nolte
.	SENT	.
