It	PP	it
's	VBZ	be
Bulger	NP	Bulger
whose	WP$	whose
grim	JJ	grim
appearance	NN	appearance
and	CC	and
even	RB	even
grimmer	JJR	grim
behaviour	NN	behaviour
'	POS	'
Black	NP	Black
Mass	NP	Mass
'	POS	'
indulges	VBZ	indulge
.	SENT	.
But	CC	but
it	PP	it
's	VBZ	be
the	DT	the
quieter	JJR	quiet
,	,	,
more	RBR	more
complicated	JJ	complicated
Connolly	NP	Connolly
who	WP	who
offers	VBZ	offer
the	DT	the
film	NN	film
's	POS	's
subtler	JJR	subtle
pleasures	NNS	pleasure
.	SENT	.
