This	DT	this
is	VBZ	be
one	CD	one
of	IN	of
those	DT	those
cases	NNS	case
where	WRB	where
fictionalizing	VBG	fictionalize
a	DT	a
true	JJ	true
event	NN	event
,	,	,
or	CC	or
at	IN	at
least	JJS	least
fusing	VBG	fuse
two	CD	two
or	CC	or
three	CD	three
real	JJ	real
people	NNS	people
into	IN	into
one	CD	one
composite	JJ	composite
character	NN	character
,	,	,
might	MD	might
have	VB	have
resulted	VBN	result
in	IN	in
tighter	JJR	tight
storytelling	NN	storytelling
.	SENT	.
