A	DT	a
jumbled	VBN	jumble
third	JJ	third
act	NN	act
and	CC	and
an	DT	an
indifferent	JJ	indifferent
ending	NN	ending
ultimately	RB	ultimately
make	VB	make
Hellions	NNS	hellion
disappointing	JJ	disappointing
.	SENT	.
But	CC	but
thereï¿½s	RB	<unknown>
a	DT	a
bit	NN	bit
of	IN	of
fun	NN	fun
to	TO	to
be	VB	be
had	VBN	have
in	IN	in
its	PP$	its
opening	NN	opening
frights	NNS	fright
,	,	,
and	CC	and
in	IN	in
trying	VBG	try
to	TO	to
figure	VB	figure
out	RP	out
what	WP	what
these	DT	these
costumed	VBN	costume
little	JJ	little
monsters	NNS	monster
really	RB	really
want	VBP	want
.	SENT	.
