A	DT	a
Taken-style	NP	<unknown>
no-holds-barred	JJ	no-holds-barred
family	NN	family
survival	NN	survival
action	NN	action
film	NN	film
,	,	,
with	IN	with
an	DT	an
inevitable	JJ	inevitable
side	NN	side
order	NN	order
of	IN	of
xenophobia	NN	xenophobia
undimmed	JJ	undimmed
by	IN	by
the	DT	the
indictment	NN	indictment
of	IN	of
faceless	JJ	faceless
corporate	JJ	corporate
chicanery	NN	chicanery
.	SENT	.
