Deftly	RB	deftly
made	VBN	make
and	CC	and
diverting	VBG	divert
for	IN	for
young	JJ	young
audiences	NNS	audience
but	CC	but
unlikely	JJ	unlikely
to	TO	to
linger	VB	linger
,	,	,
with	IN	with
any	DT	any
vibrancy	NN	vibrancy
tempered	VBN	temper
by	IN	by
the	DT	the
familiarity	NN	familiarity
of	IN	of
the	DT	the
tune	NN	tune
.	SENT	.
