Even	RB	even
with	IN	with
its	PP$	its
well-observed	JJ	<unknown>
moments	NNS	moment
,	,	,
the	DT	the
movie	NN	movie
's	POS	's
nonmusical	JJ	<unknown>
interactions	NNS	interaction
,	,	,
whether	IN	whether
reaching	VBG	reach
for	IN	for
laughs	NNS	laugh
or	CC	or
poignancy	NN	poignancy
,	,	,
too	RB	too
often	RB	often
feel	VB	feel
flat	JJ	flat
and	CC	and
forced	VBN	force
.	SENT	.
