The	DT	the
movie	NN	movie
itself	PP	itself
seems	VBZ	seem
equally	RB	equally
divided	VBN	divide
between	IN	between
the	DT	the
sensibilities	NNS	sensibility
of	IN	of
hyperverbal	JJ	<unknown>
writer	NN	writer
Diablo	NP	Diablo
Cody	NP	Cody
and	CC	and
music-centric	JJ	<unknown>
director	NN	director
Jonathan	NP	Jonathan
Demme	NP	Demme
,	,	,
and	CC	and
ends	VBZ	end
up	RP	up
falling	VBG	fall
into	IN	into
a	DT	a
muddy	JJ	muddy
gap	NN	gap
between	IN	between
the	DT	the
two	CD	two
.	SENT	.
