The	DT	the
oddball	JJ	oddball
script	NN	script
by	IN	by
Mitch	NP	Mitch
Glazer	NP	Glazer
(	(	(
Scrooged	JJ	<unknown>
)	)	)
,	,	,
as	RB	as
directed	VBN	direct
by	IN	by
Barry	NP	Barry
Levinson	NP	Levinson
(	(	(
Rain	NP	Rain
Man	NP	Man
,	,	,
Good	NP	Good
Morning	NP	Morning
,	,	,
Vietnam	NP	Vietnam
)	)	)
,	,	,
takes	VBZ	take
so	RB	so
long	JJ	long
to	TO	to
bring	VB	bring
Richie	NP	Richie
and	CC	and
Salima	NP	<unknown>
together	RB	together
,	,	,
it	PP	it
deprives	VBZ	deprive
us	PP	us
of	IN	of
the	DT	the
kind	NN	kind
of	IN	of
fully	RB	fully
fleshed	VBN	flesh
dynamic	JJ	dynamic
the	DT	the
story	NN	story
so	RB	so
desperately	RB	desperately
needs	VBZ	need
.	SENT	.
