Featuring	VBG	feature
none	NN	none
of	IN	of
its	PP$	its
predecessor	NN	predecessor
's	POS	's
sumptuous	JJ	sumptuous
pitch-black	JJ	pitch-black
visuals	NNS	visual
and	CC	and
sense	NN	sense
of	IN	of
creeping	VBG	creep
dread	NN	dread
,	,	,
Ciaran	NP	Ciaran
Foy	NP	Foy
's	POS	's
follow-up	NN	follow-up
is	VBZ	be
a	DT	a
misbegotten	JJ	misbegotten
venture	NN	venture
at	IN	at
every	DT	every
turn	NN	turn
,	,	,
in	IN	in
large	JJ	large
part	NN	part
because	IN	because
it	PP	it
follows	VBZ	follow
the	DT	the
horror	NN	horror
sophomore	NN	sophomore
rulebook	NN	rulebook
so	RB	so
closely	RB	closely
.	SENT	.
