I	PP	I
know	VBP	know
the	DT	the
opening	VBG	open
credits	NNS	credit
for	IN	for
a	DT	a
James	NP	James
Bond	NP	Bond
movie	NN	movie
are	VBP	be
supposed	VBN	suppose
to	TO	to
be	VB	be
silly	JJ	silly
,	,	,
but	CC	but
the	DT	the
start	NN	start
of	IN	of
Spectre	NP	<unknown>
achieves	VBZ	achieve
almost	RB	almost
orgasmic	JJ	orgasmic
levels	NNS	level
of	IN	of
kitsch	NN	kitsch
.	SENT	.
