Like	IN	like
Skyfall	NP	<unknown>
,	,	,
Spectre	NP	<unknown>
is	VBZ	be
loaded	VBN	load
with	IN	with
allusions	NNS	allusion
to	TO	to
the	DT	the
previous	JJ	previous
films	NNS	film
in	IN	in
the	DT	the
franchise	NN	franchise
,	,	,
undoubtedly	RB	undoubtedly
providing	VBG	provide
much	JJ	much
glee	NN	glee
for	IN	for
Bond	NN	bond
fans	NNS	fan
.	SENT	.
The	DT	the
nods	NNS	nod
,	,	,
quips	NNS	quip
,	,	,
and	CC	and
general	JJ	general
formula	NN	formula
that	IN	that
audiences	NNS	audience
have	VBP	have
come	VBN	come
to	TO	to
know	VB	know
soon	RB	soon
becomes	VBZ	become
weary	JJ	weary
and	CC	and
tiring	VBG	tire
,	,	,
however	RB	however
.	SENT	.
