As	IN	as
directed	VBN	direct
by	IN	by
Robert	NP	Robert
Zemeckis	NP	Zemeckis
from	IN	from
a	DT	a
script	NN	script
he	PP	he
co-wrote	NN	co-wrote
with	IN	with
Christopher	NP	Christopher
Browne	NP	Browne
,	,	,
the	DT	the
film	NN	film
limps	VBZ	limp
through	IN	through
its	PP$	its
first	JJ	first
two	CD	two
acts	NNS	act
,	,	,
putting	VBG	put
in	IN	in
time	NN	time
until	IN	until
the	DT	the
big	JJ	big
moment	NN	moment
.	SENT	.
