Amidst	IN	amidst
this	DT	this
goofiness	NN	goofiness
,	,	,
Skrein	NP	<unknown>
proves	VBZ	prove
a	DT	a
serviceable	JJ	serviceable
Statham	NP	Statham
replacement	NN	replacement
,	,	,
capable	JJ	capable
of	IN	of
executing	VBG	execute
elaborate	JJ	elaborate
martial	JJ	martial
arts-inspired	JJ	<unknown>
fight	NN	fight
moves	NNS	move
,	,	,
glowering	VBG	glower
behind	IN	behind
the	DT	the
wheel	NN	wheel
of	IN	of
his	PP$	his
car	NN	car
,	,	,
and	CC	and
generally	RB	generally
acting	VBG	act
like	IN	like
a	DT	a
cold	JJ	cold
,	,	,
detached	JJ	detached
thug-for-hire	NN	<unknown>
who	WP	who
,	,	,
deep	RB	deep
down	RB	down
,	,	,
has	VBZ	have
a	DT	a
heart	NN	heart
of	IN	of
gold	NN	gold
.	SENT	.
