Given	VBN	give
the	DT	the
level	NN	level
of	IN	of
talent	NN	talent
involved	VBN	involve
both	CC	both
in	IN	in
front	NN	front
of	IN	of
and	CC	and
behind	IN	behind
the	DT	the
camera	NN	camera
,	,	,
nobody	NN	nobody
should	MD	should
feel	VB	feel
much	JJ	much
joy	NN	joy
—	NN	<unknown>
no	DT	no
anti-tentpole	NN	<unknown>
schadenfreude	NN	<unknown>
or	CC	or
blockbuster-busting	NN	<unknown>
righteousness	NN	righteousness
—	NN	<unknown>
to	TO	to
discover	VB	discover
that	IN	that
the	DT	the
latest	JJS	late
Fantastic	JJ	fantastic
Four	NP	Four
film	NN	film
is	VBZ	be
a	DT	a
catastrophe	NN	catastrophe
