A	DT	a
good	JJ	good
cast	NN	cast
led	VBN	lead
by	IN	by
Miles	NP	Miles
Teller	NP	Teller
gets	VBZ	get
swallowed	VBN	swallow
up	RP	up
in	IN	in
a	DT	a
narrative	NN	narrative
that	WDT	that
grows	VBZ	grow
progressively	RB	progressively
more	RBR	more
muddled	VBN	muddle
and	CC	and
tedious	JJ	tedious
.	SENT	.
