It	PP	it
's	VBZ	be
clear	JJ	clear
that	IN	that
Roth	NP	Roth
was	VBD	be
trying	VBG	try
to	TO	to
say	VB	say
something	NN	something
about	IN	about
the	DT	the
brave	JJ	brave
new	JJ	new
world	NN	world
of	IN	of
social	JJ	social
media-enabled	JJ	<unknown>
social	JJ	social
justice	NN	justice
,	,	,
and	CC	and
public	JJ	public
shame	NN	shame
as	IN	as
a	DT	a
tool	NN	tool
for	IN	for
change	NN	change
,	,	,
but	CC	but
the	DT	the
message	NN	message
is	VBZ	be
garbled	VBN	garble
.	SENT	.
That	IN	that
it	PP	it
comes	VBZ	come
wrapped	VBN	wrap
in	IN	in
a	DT	a
horror	NN	horror
package	NN	package
that	WDT	that
just	RB	just
is	VBZ	be
n't	RB	n't
truly	RB	truly
scary	JJ	scary
or	CC	or
suspenseful	JJ	suspenseful
is	VBZ	be
the	DT	the
real	JJ	real
shame	NN	shame
though	RB	though
.	SENT	.
