While	IN	while
it’s	NNS	<unknown>
impossible	JJ	impossible
not	RB	not
to	TO	to
be	VB	be
somewhat	RB	somewhat
caught	VBN	catch
up	RP	up
in	IN	in
these	DT	these
climbers	NNS	climber
’	NN	<unknown>
life-or-death	NN	life-or-death
struggle	NN	struggle
,	,	,
Everest	NP	Everest
is	VBZ	be
oddly	RB	oddly
uninvolving	JJ	<unknown>
—	NN	<unknown>
it	PP	it
depicts	VBZ	depict
a	DT	a
horrific	JJ	horrific
scenario	NN	scenario
in	IN	in
an	DT	an
underwhelming	JJ	underwhelming
,	,	,
distancing	VBG	distance
way	NN	way
.	SENT	.
