The	DT	the
production	NN	production
design	NN	design
and	CC	and
effects	NNS	effect
for	IN	for
this	DT	this
apocalyptic	JJ	apocalyptic
terrain	NN	terrain
are	VBP	be
way	NN	way
above	IN	above
par	NN	par
for	IN	for
this	DT	this
sort	NN	sort
of	IN	of
thing	NN	thing
,	,	,
and	CC	and
evidence	NN	evidence
of	IN	of
a	DT	a
much	RB	much
higher	JJR	high
budget	NN	budget
than	IN	than
Ball	NP	Ball
had	VBD	have
first	JJ	first
time	NN	time
around	RB	around
.	SENT	.
