Ricki	NP	Ricki
And	CC	and
the	DT	the
Flash	NP	Flash
is	VBZ	be
about	IN	about
mistakes	NNS	mistake
,	,	,
regrets	NNS	regret
,	,	,
and	CC	and
of	IN	of
course	NN	course
,	,	,
redemption	NN	redemption
,	,	,
but	CC	but
all	DT	all
of	IN	of
it	PP	it
feels	VBZ	feel
a	DT	a
little	JJ	little
too	RB	too
neat	JJ	neat
,	,	,
familiar	JJ	familiar
and	CC	and
convenient	JJ	convenient
even	RB	even
if	IN	if
no	DT	no
one’s	NNS	<unknown>
quite	RB	quite
belting	VBG	belt
out	RP	out
“	JJ	<unknown>
Kumbaya	NP	<unknown>
”	NN	<unknown>
by	IN	by
the	DT	the
end	NN	end
.	SENT	.
