An	DT	an
unbalanced	JJ	unbalanced
but	CC	but
never	RB	never
less	RBR	less
than	IN	than
entertaining	JJ	entertaining
film	NN	film
,	,	,
enthralling	VBG	enthrall
and	CC	and
deflating	VBG	deflate
in	IN	in
roughly	RB	roughly
equal	JJ	equal
measure	NN	measure
,	,	,
and	CC	and
studded	VBN	stud
with	IN	with
moments	NNS	moment
of	IN	of
true	JJ	true
,	,	,
old-school	NN	old-school
glory	NN	glory
.	SENT	.
