Straight	JJ	straight
Outta	NP	<unknown>
Compton	NP	Compton
soars	NNS	soar
for	IN	for
an	DT	an
hour	NN	hour
before	IN	before
spiralling	VBG	spiral
into	IN	into
a	DT	a
bloated	JJ	bloated
,	,	,
melodramatic	JJ	melodramatic
mess	NN	mess
.	SENT	.
Still	RB	still
,	,	,
itâ€™s	NNS	<unknown>
worth	VBP	worth
it	PP	it
for	IN	for
the	DT	the
early	JJ	early
ferocity	NN	ferocity
,	,	,
capturing	VBG	capture
just	RB	just
how	WRB	how
powerful	JJ	powerful
N.W.A	NP	<unknown>
really	RB	really
were	VBD	be
.	SENT	.
