The	DT	the
Green	NP	Green
Inferno	NP	<unknown>
will	MD	will
be	VB	be
gleefully	RB	gleefully
offensive	JJ	offensive
and	CC	and
unpalatable	JJ	unpalatable
to	TO	to
mainstream	JJ	mainstream
audiences	NNS	audience
,	,	,
who	WP	who
may	MD	may
be	VB	be
more	RBR	more
similar	JJ	similar
to	TO	to
The	DT	the
Green	NP	Green
Inferno’s	NP	<unknown>
victims	NNS	victim
than	IN	than
they’d	NNS	<unknown>
like	VBP	like
to	TO	to
think	VB	think
.	SENT	.
No	DT	no
one	CD	one
could	MD	could
accuse	VB	accuse
Roth	NP	Roth
of	IN	of
lacking	VBG	lack
guts	NNS	gut
–	JJ	<unknown>
even	RB	even
if	IN	if
he	PP	he
hasn’t	NN	<unknown>
found	VBD	find
the	DT	the
perfect	JJ	perfect
recipe	NN	recipe
for	IN	for
them	PP	them
.	SENT	.
