Mr.	NP	Mr.
Ritchie	NP	Ritchie
tends	VBZ	tend
to	TO	to
flaunt	VB	flaunt
his	PP$	his
wares	NNS	ware
like	IN	like
a	DT	a
store	NN	store
clerk	NN	clerk
,	,	,
fawning	VBG	fawn
over	IN	over
the	DT	the
clothes	NNS	clothes
,	,	,
chairs	NNS	chair
and	CC	and
cars	NNS	car
,	,	,
and	CC	and
his	PP$	his
usual	JJ	usual
rabbity	NN	<unknown>
pace	NN	pace
slows	VBZ	slow
to	TO	to
a	DT	a
tortoiselike	JJ	<unknown>
crawl	NN	crawl
whenever	WRB	whenever
the	DT	the
actors	NNS	actor
deliver	VBP	deliver
a	DT	a
lot	NN	lot
of	IN	of
words	NNS	word
,	,	,
which	WDT	which
gratefully	RB	gratefully
isnâ€™t	VBD	<unknown>
often	RB	often
.	SENT	.
His	PP$	his
talent	NN	talent
,	,	,
as	IN	as
he	PP	he
proves	VBZ	prove
repeatedly	RB	repeatedly
,	,	,
is	VBZ	be
making	VBG	make
bodies	NNS	body
and	CC	and
cars	NNS	car
crash	NN	crash
through	IN	through
space	NN	space
.	SENT	.
