Interspersed	VBN	intersperse
between	IN	between
the	DT	the
misogyny	NN	misogyny
and	CC	and
flatulence	NN	flatulence
jokes	NNS	joke
apparently	RB	apparently
left	VBD	leave
over	RP	over
from	IN	from
Pooh	NP	Pooh
's	POS	's
co-written	VBN	co-write
script	NN	script
for	IN	for
Friday	NP	Friday
,	,	,
there	EX	there
's	VBZ	be
a	DT	a
story	NN	story
about	IN	about
an	DT	an
ex-con	NN	ex-con
.	SENT	.
