A	DT	a
better	JJR	good
title	NN	title
would	MD	would
've	VBP	have
likely	RB	likely
been	VBN	be
121	CD	@card@
Minutes	NPS	Minutes
in	IN	in
Purgatory	NP	<unknown>
,	,	,
since	IN	since
that	WDT	that
's	VBZ	be
essentially	RB	essentially
where	WRB	where
audiences	NNS	audience
will	MD	will
find	VB	find
themselves	PP	themselves
residing	VBG	reside
during	IN	during
the	DT	the
entirety	NN	entirety
of	IN	of
this	DT	this
dreary	JJ	dreary
slog	NN	slog
down	IN	down
a	DT	a
familiar	JJ	familiar
road	NN	road
paved	VBN	pave
with	IN	with
painfully	RB	painfully
good	JJ	good
intentions	NNS	intention
.	SENT	.
