Small-screen	NN	small-screen
comic	JJ	comic
talent	NN	talent
is	VBZ	be
all	RB	all
over	IN	over
Fresno	NP	Fresno
,	,	,
with	IN	with
key	JJ	key
players	NNS	player
from	IN	from
series	NN	series
including	VBG	include
Parks	NP	Parks
&	CC	&
Rec	NP	Rec
,	,	,
Arrested	NP	<unknown>
Development	NP	Development
and	CC	and
Portlandia	NP	<unknown>
teaming	VBG	team
up	RP	up
for	IN	for
a	DT	a
tale	NN	tale
of	IN	of
two	CD	two
sisters	NNS	sister
stuck	VBN	stick
with	IN	with
a	DT	a
hard-to-dispose-of	JJ	<unknown>
dead	JJ	dead
body	NN	body
.	SENT	.
The	DT	the
feature	NN	feature
,	,	,
sadly	RB	sadly
,	,	,
exhibits	VBZ	exhibit
none	NN	none
of	IN	of
the	DT	the
smarts	NNS	smart
or	CC	or
agility	NN	agility
that	WDT	that
fuel	VB	fuel
those	DT	those
series	NN	series
.	SENT	.
