A	DT	a
rather	RB	rather
dull	JJ	dull
and	CC	and
talkative	JJ	talkative
comedy	NN	comedy
about	IN	about
two	CD	two
mismatched	VBN	mismatch
colleagues	NNS	colleague
trapped	VBN	trap
in	IN	in
Albuquerque	NP	Albuquerque
for	IN	for
a	DT	a
day	NN	day
of	IN	of
true	JJ	true
confessions	NNS	confession
and	CC	and
misbehavior	NN	misbehavior
.	SENT	.
