The	DT	the
plot	NN	plot
is	VBZ	be
just	RB	just
high-tech	JJ	high-tech
Swiss	NP	Swiss
Cheese	NP	Cheese
,	,	,
filled	VBN	fill
with	IN	with
holes	NNS	hole
and	CC	and
smelling	VBG	smell
like	IN	like
last	JJ	last
week	NN	week
's	POS	's
refrigerator	NN	refrigerator
contents	NNS	content
.	SENT	.
