Sure	RB	sure
,	,	,
Peeples	NP	Peeples
has	VBZ	have
a	DT	a
nice	JJ	nice
(	(	(
if	IN	if
unmemorable	JJ	unmemorable
)	)	)
voice	NN	voice
,	,	,
but	CC	but
the	DT	the
vapid	JJ	vapid
storyline	NN	storyline
with	IN	with
fantastic	JJ	fantastic
overtones	NNS	overtone
transports	VBZ	transport
Jem	NN	Jem
and	CC	and
the	DT	the
Holograms	NNS	Hologram
into	IN	into
another	DT	another
dimension	NN	dimension
,	,	,
one	CD	one
that	WDT	that
's	VBZ	be
utterly	RB	utterly
flat	JJ	flat
.	SENT	.
Control	NN	control
.	SENT	.
Alt	NP	Alt
.	SENT	.
Delete	VB	delete
.	SENT	.
