Strict	JJ	strict
adherence	NN	adherence
to	TO	to
the	DT	the
playbook	NN	playbook
may	MD	may
work	VB	work
in	IN	in
sports	NNS	sport
,	,	,
but	CC	but
My	PP$	my
All	NP	All
American	NP	American
shows	VBZ	show
the	DT	the
pitfalls	NNS	pitfall
of	IN	of
that	DT	that
approach	NN	approach
with	IN	with
movies	NNS	movie
.	SENT	.
