Move	NN	move
over	RB	over
,	,	,
Rudy	NP	Rudy
.	SENT	.
Hit	VBN	hit
the	DT	the
showers	NNS	shower
,	,	,
Brian�s	NP	<unknown>
Song	NP	Song
.	SENT	.
There�s	RB	<unknown>
a	DT	a
new	JJ	new
tearjerking	JJ	<unknown>
true	JJ	true
story	NN	story
of	IN	of
gridiron	NN	gridiron
triumph	NN	triumph
,	,	,
one	CD	one
that	WDT	that
combines	VBZ	combine
those	DT	those
male-weepie	NN	<unknown>
favorites	NNS	favorite
in	IN	in
a	DT	a
way	NN	way
no	DT	no
focus	NN	focus
group	NN	group
could	MD	could
possibly	RB	possibly
resist	VB	resist
.	SENT	.
