Pan	NP	Pan
is	VBZ	be
a	DT	a
cacophonous	JJ	cacophonous
assault	NN	assault
on	IN	on
the	DT	the
senses	NNS	sense
,	,	,
all	DT	all
computerized	JJ	computerized
cinematographic	JJ	cinematographic
mayhem	NN	mayhem
and	CC	and
deafening	VBG	deafen
noise	NN	noise
,	,	,
and	CC	and
its	PP$	its
hurried	JJ	hurried
pace	NN	pace
extinguishes	VBZ	extinguish
any	DT	any
genuine	JJ	genuine
character	NN	character
development	NN	development
.	SENT	.
