Loud	RB	loud
,	,	,
repellent	JJ	repellent
,	,	,
badly	RB	badly
written	VBN	write
,	,	,
indifferently	RB	indifferently
directed	VBN	direct
and	CC	and
almost	RB	almost
completely	RB	completely
devoid	JJ	devoid
of	IN	of
any	DT	any
genuine	JJ	genuine
laughs	NNS	laugh
,	,	,
Scouts	NP	<unknown>
Guide	NP	Guide
to	TO	to
the	DT	the
Zombie	NP	<unknown>
Apocalypse	NN	apocalypse
is	VBZ	be
essentially	RB	essentially
a	DT	a
film	NN	film
for	IN	for
12-year-old	JJ	12-year-old
boys	NNS	boy
who	WP	who
can	MD	can
still	RB	still
derive	VB	derive
some	DT	some
kind	NN	kind
of	IN	of
basic	JJ	basic
entertainment	NN	entertainment
for	IN	for
the	DT	the
mere	JJ	mere
sight	NN	sight
of	IN	of
spurting	VBG	spurt
blood	NN	blood
or	CC	or
a	DT	a
bare	JJ	bare
breast	NN	breast
,	,	,
all	PDT	all
the	DT	the
better	JJR	good
if	IN	if
they	PP	they
can	MD	can
appear	VB	appear
at	IN	at
the	DT	the
same	JJ	same
time	NN	time
