First-time	JJ	first-time
directors	NNS	director
Scott	NP	Scott
Alexander	NP	Alexander
and	CC	and
Larry	NP	Larry
Karaszewski	NP	<unknown>
must	MD	must
have	VB	have
written	VBN	write
the	DT	the
script	NN	script
for	IN	for
this	DT	this
comedy	NN	comedy
when	WRB	when
they	PP	they
were	VBD	be
about	RB	about
12--and	JJ	<unknown>
not	RB	not
changed	VBN	change
a	DT	a
word	NN	word
.	SENT	.
