The	DT	the
characters	NNS	character
'	POS	'
marginalized	VBN	marginalize
social	JJ	social
standing	NN	standing
is	VBZ	be
less	RBR	less
indicative	JJ	indicative
of	IN	of
a	DT	a
real-life	JJ	real-life
epidemic	NN	epidemic
and	CC	and
more	RBR	more
akin	JJ	akin
to	TO	to
window	NN	window
dressing	NN	dressing
.	SENT	.
