Bad	JJ	bad
movies	NNS	movie
can	MD	can
be	VB	be
a	DT	a
hoot	NN	hoot
,	,	,
but	CC	but
rather	RB	rather
than	IN	than
campy	NN	campy
,	,	,
Ameer	NP	Ameer
appears	VBZ	appear
to	TO	to
be	VB	be
dead	RB	dead
serious	JJ	serious
;	:	;
and	CC	and
it	PP	it
's	VBZ	be
hard	JJ	hard
to	TO	to
feel	VB	feel
anything	NN	anything
but	CC	but
fury	NN	fury
toward	IN	toward
a	DT	a
filmmaker	NN	filmmaker
whose	WP$	whose
opening	NN	opening
title	NN	title
sequence	NN	sequence
intersperses	VBZ	intersperse
black-and-white	JJ	black-and-white
flashbacks	NNS	flashback
of	IN	of
his	PP$	his
sexy	JJ	sexy
young	JJ	young
lovers	NNS	lover
with	IN	with
actual	JJ	actual
concentration-camp	NN	concentration-camp
photos	NNS	photo
of	IN	of
stacked	VBN	stack
,	,	,
emaciated	VBN	emaciate
corpses	NNS	corps
.	SENT	.
