Blanchett	NP	Blanchett
,	,	,
as	IN	as
you�d	NNS	<unknown>
imagine	VBP	imagine
,	,	,
is	VBZ	be
riveting	JJ	riveting
,	,	,
even	RB	even
when	WRB	when
she�s	NNS	<unknown>
saddled	VBD	saddle
with	IN	with
the	DT	the
movie�s	JJ	<unknown>
on-the-nose	JJ	<unknown>
dialogue	NN	dialogue
,	,	,
not	RB	not
to	TO	to
mention	VB	mention
a	DT	a
handful	NN	handful
of	IN	of
fairly	RB	fairly
contrived	JJ	contrived
domestic	JJ	domestic
scenes	NNS	scene
.	SENT	.
