For	IN	for
all	DT	all
of	IN	of
its	PP$	its
flaws	NNS	flaw
,	,	,
it	PP	it
's	VBZ	be
the	DT	the
first	JJ	first
film	NN	film
since	IN	since
Eastern	NP	Eastern
Promises	NP	<unknown>
that	WDT	that
has	VBZ	have
added	VBN	add
anything	NN	anything
truly	RB	truly
fresh	JJ	fresh
to	TO	to
the	DT	the
old	JJ	old
school	NN	school
street-level	JJ	street-level
gangster	NN	gangster
story	NN	story
.	SENT	.
