Cooper	NP	Cooper
,	,	,
the	DT	the
director	NN	director
of	IN	of
Crazy	NP	Crazy
Heart	NP	Heart
and	CC	and
the	DT	the
underrated	VBD	underrate
Out	RB	out
of	IN	of
the	DT	the
Furnace	NP	Furnace
,	,	,
has	VBZ	have
made	VBN	make
a	DT	a
tight	JJ	tight
and	CC	and
tense	JJ	tense
gangster	NN	gangster
film	NN	film
with	IN	with
Black	NP	Black
Mass.	NP	Mass.
But	CC	but
itï¿½s	NP	<unknown>
a	DT	a
pretty	JJ	pretty
straight-ahead	NN	straight-ahead
entry	NN	entry
in	IN	in
the	DT	the
genre	NN	genre
,	,	,
albeit	IN	albeit
one	PP	one
peppered	VBD	pepper
with	IN	with
spicy	JJ	spicy
performances	NNS	performance
.	SENT	.
