Compelling	JJ	compelling
and	CC	and
powerfully	RB	powerfully
acted	VBN	act
,	,	,
with	IN	with
just	RB	just
enough	JJ	enough
wrinkles	NNS	wrinkle
to	TO	to
avoid	VB	avoid
the	DT	the
ghosts	NNS	ghost
of	IN	of
gangster	NN	gangster
movies	NNS	movie
past	JJ	past
.	SENT	.
Depp	NP	Depp
's	POS	's
appearance	NN	appearance
might	MD	might
distract	VB	distract
some	DT	some
,	,	,
but	CC	but
it	PP	it
's	VBZ	be
good	JJ	good
to	TO	to
see	VB	see
him	PP	him
back	RB	back
in	IN	in
the	DT	the
groove	NN	groove
.	SENT	.
