This	DT	this
covertly	RB	covertly
brawny	JJ	brawny
film	NN	film
,	,	,
with	IN	with
a	DT	a
script	NN	script
by	IN	by
Matt	NP	Matt
Charman	NP	Charman
and	CC	and
Joel	NP	Joel
and	CC	and
Ethan	NP	Ethan
Coen	NP	Coen
,	,	,
has	VBZ	have
plot	NN	plot
points	NNS	point
that	WDT	that
click	VBP	click
like	IN	like
pegs	NNS	peg
under	IN	under
Spielberg	NP	Spielberg
's	POS	's
tight	JJ	tight
direction	NN	direction
.	SENT	.
In	IN	in
his	PP$	his
fourth	JJ	fourth
pairing	VBG	pair
with	IN	with
Hanks	NP	Hanks
,	,	,
Spielberg	NP	Spielberg
again	RB	again
examines	VBZ	examine
the	DT	the
furtive	JJ	furtive
face	NN	face
of	IN	of
justice	NN	justice
and	CC	and
issues	VBZ	issue
another	DT	another
masterful	JJ	masterful
ruling	NN	ruling
.	SENT	.
