It�s	NNS	<unknown>
not	RB	not
easy	JJ	easy
to	TO	to
make	VB	make
a	DT	a
movie	NN	movie
as	IN	as
beautiful	JJ	beautiful
as	IN	as
Brooklyn	NP	Brooklyn
,	,	,
where	WRB	where
the	DT	the
stakes	NNS	stake
are	VBP	be
low	JJ	low
but	CC	but
the	DT	the
outcome	NN	outcome
really	RB	really
matters	VBZ	matter
.	SENT	.
This	DT	this
is	VBZ	be
an	DT	an
old-fashioned	JJ	old-fashioned
entertainment	NN	entertainment
,	,	,
but	CC	but
one	PP	one
so	RB	so
masterfully	RB	masterfully
crafted	VBN	craft
and	CC	and
heartfelt	JJ	heartfelt
that	IN	that
it�s	NNS	<unknown>
hard	RB	hard
not	RB	not
to	TO	to
love	VB	love
.	SENT	.
