Mara	NP	Mara
and	CC	and
Blanchett	NP	Blanchett
make	VBP	make
for	IN	for
an	DT	an
unforgettable	JJ	unforgettable
couple	NN	couple
in	IN	in
a	DT	a
beautiful	JJ	beautiful
film	NN	film
about	IN	about
longing	NN	longing
,	,	,
loss	NN	loss
and	CC	and
the	DT	the
confusion	NN	confusion
and	CC	and
wonder	NN	wonder
of	IN	of
love	NN	love
.	SENT	.
