Quite	PDT	Quite
a	DT	a
few	JJ	few
filmgoers	NNS	<unknown>
lament	VBP	lament
the	DT	the
shortage	NN	shortage
of	IN	of
movies	NNS	movie
for	IN	for
adults	NNS	adult
.	SENT	.
Ricki	NP	Ricki
and	CC	and
the	DT	the
Flash	NP	Flash
goes	VBZ	go
against	IN	against
that	DT	that
trend	NN	trend
with	IN	with
rock	NN	rock
'	POS	'
n	NN	n
'	POS	'
roll	NN	roll
attitude	NN	attitude
.	SENT	.
