Co-director	NN	co-director
Starzack	NN	<unknown>
was	VBD	be
one	CD	one
of	IN	of
the	DT	the
guiding	JJ	guiding
hands	NNS	hand
behind	IN	behind
the	DT	the
series	NN	series
version	NN	version
of	IN	of
Shaun	NP	Shaun
the	DT	the
Sheep	NP	Sheep
,	,	,
and	CC	and
that	DT	that
experience	NN	experience
in	IN	in
the	DT	the
kind	NN	kind
of	IN	of
brisk	JJ	brisk
,	,	,
skit-based	JJ	<unknown>
comedy	NN	comedy
that	WDT	that
makes	VBZ	make
the	DT	the
series	NN	series
so	IN	so
charming	JJ	charming
shows	NNS	show
through	IN	through
here	RB	here
in	IN	in
stand-alone	JJ	stand-alone
scenes	NNS	scene
.	SENT	.
