From	IN	from
the	DT	the
company	NN	company
that	WDT	that
gave	VBD	give
us	PP	us
Chicken	NP	Chicken
Run	NP	<unknown>
and	CC	and
Wallace	NP	Wallace
and	CC	and
Gromit	NP	<unknown>
,	,	,
this	DT	this
adorable	JJ	adorable
tale	NN	tale
about	IN	about
a	DT	a
sheep	NN	sheep
who	WP	who
leads	VBZ	lead
his	PP$	his
comrades	NNS	comrade
on	IN	on
a	DT	a
big-city	JJ	big-city
adventure	NN	adventure
is	VBZ	be
some	DT	some
of	IN	of
the	DT	the
most	RBS	most
pure	JJ	pure
visual	JJ	visual
storytelling	NN	storytelling
you	PP	you
're	VBP	be
going	VBG	go
to	TO	to
see	VB	see
this	DT	this
year	NN	year
.	SENT	.
