Spotlight	NN	spotlight
is	VBZ	be
a	DT	a
great	JJ	great
newspaper	NN	newspaper
movie	NN	movie
,	,	,
ranking	VBG	rank
up	RP	up
there	RB	there
with	IN	with
All	PDT	All
the	DT	the
President�s	NP	<unknown>
Men	NP	Men
and	CC	and
Citizen	NP	Citizen
Kane	NP	Kane
,	,	,
and	CC	and
it�s	NNS	<unknown>
certainly	RB	certainly
the	DT	the
best	JJS	good
of	IN	of
its	PP$	its
kind	NN	kind
since	IN	since
The	DT	the
Paper	NN	paper
in	IN	in
1994	CD	@card@
,	,	,
which	WDT	which
also	RB	also
happened	VBD	happen
to	TO	to
star	VB	star
Michael	NP	Michael
Keaton	NP	Keaton
.	SENT	.
