The	DT	the
year	NN	year
is	VBZ	be
not	RB	not
over	RB	over
,	,	,
but	CC	but
I�ve	NP	<unknown>
already	RB	already
seen	VBN	see
my	PP$	my
favorite	JJ	favorite
film	NN	film
of	IN	of
2015	CD	@card@
.	SENT	.
It�s	NP	<unknown>
Thomas	NP	Thomas
McCarthy�s	NP	<unknown>
brilliant	JJ	brilliant
,	,	,
responsible	JJ	responsible
,	,	,
galvanizing	VBG	galvanize
and	CC	and
unforgettable	JJ	unforgettable
Spotlight	NN	spotlight
.	SENT	.
