Like	IN	like
All	PDT	All
The	DT	the
President�s	NP	<unknown>
Men	NP	Men
,	,	,
it�s	NN	<unknown>
a	DT	a
muckraker	NN	muckraker
movie	NN	movie
that	WDT	that
celebrates	VBZ	celebrate
the	DT	the
power	NN	power
of	IN	of
the	DT	the
press	NN	press
by	IN	by
actually	RB	actually
showing	VBG	show
journalists	NNS	journalist
doing	VBG	do
their	PP$	their
job	NN	job
,	,	,
pen	NN	pen
and	CC	and
notebook	NN	notebook
in	IN	in
hand	NN	hand
.	SENT	.
