This	DT	this
is	VBZ	be
a	DT	a
love	NN	love
letter	NN	letter
to	TO	to
lunacy	NN	lunacy
(	(	(
and	CC	and
an	DT	an
unspoken	JJ	unspoken
tribute	NN	tribute
to	TO	to
the	DT	the
iconic	JJ	iconic
towers	NNS	tower
)	)	)
that	WDT	that
lets	VBZ	let
you	PP	you
feel	VBP	feel
what	WP	what
itï¿½s	NNS	<unknown>
like	VBP	like
to	TO	to
tread	VB	tread
where	WRB	where
only	JJ	only
gods	NNS	god
dare	VBP	dare
.	SENT	.
