Lucy	NP	Lucy
(	(	(
Hadley	NP	Hadley
Belle	NP	Belle
Miller	NP	Miller
)	)	)
is	VBZ	be
still	RB	still
full	JJ	full
of	IN	of
nickel-a-session	NN	<unknown>
psychotherapy	NN	psychotherapy
,	,	,
Linus	NP	Linus
still	RB	still
soulful	JJ	soulful
enough	RB	enough
to	TO	to
recognize	VB	recognize
his	PP$	his
friend�s	NN	<unknown>
heart	NN	heart
.	SENT	.
And	CC	and
Charlie�s	NP	<unknown>
sister	NN	sister
Sally	NP	Sally
(	(	(
Mariel	NP	Mariel
Sheets	NP	Sheets
)	)	)
still	RB	still
assumes	VBZ	assume
Linus	NP	Linus
is	VBZ	be
her	PP$	her
�Sweet	NN	<unknown>
Baboo.�	NP	<unknown>
