In	IN	in
an	DT	an
age	NN	age
of	IN	of
digital	JJ	digital
chaos	NN	chaos
and	CC	and
deep	JJ	deep
emotional	JJ	emotional
themes	NNS	theme
The	DT	the
Peanuts	NP	Peanuts
Movie	NP	Movie
keeps	VBZ	keep
things	NNS	thing
sweet	JJ	sweet
and	CC	and
simple	JJ	simple
,	,	,
perfectly	RB	perfectly
in	IN	in
tune	NN	tune
with	IN	with
the	DT	the
qualities	NNS	quality
Schulz	NP	Schulz
fans	NNS	fan
adore	VBP	adore
.	SENT	.
