McGuiganï¿½s	NNS	<unknown>
visually	RB	visually
vivid	JJ	vivid
Victor	NP	Victor
Frankenstein	NP	Frankenstein
races	NNS	race
to	TO	to
its	PP$	its
lightning-storm	NN	<unknown>
finish	NN	finish
,	,	,
running	VBG	run
over	IN	over
the	DT	the
solid	JJ	solid
(	(	(
if	IN	if
not	RB	not
electrifying	VBG	electrify
)	)	)
acting	VBG	act
of	IN	of
McAvoy	NP	McAvoy
and	CC	and
Radcliffe	NP	Radcliffe
.	SENT	.
